[
	{ 
		"id": 0,
		"level": 1,
		"difficulty": "easy",
		"grid": [0, 1, 1, 1, 1, 1, 0, 1, 1, 1, 0,
				 0, 1, 1, 0, 0, 0, 1, 1, 1, 1, 1,
				 1, 1, 1, 1, 1, 1, 1, 0, 1, 1, 1,
				 0, 1, 1, 0, 0, 1, 1, 1, 0, 0, 0,
				 1,  1, 1, 1, 1],
		"pieces": [
				[1, 1, 0, 0,  0, 1, 0, 0,  0, 0, 0, 0,  0, 0, 0, 0],
				[0, 1, 0, 0,  0, 1, 0, 0,  1, 0, 0, 0,  0, 1, 1, 0],
				[1, 0, 0, 0,  0, 1, 0, 0,  1, 1, 0, 0,  0, 0, 0, 0],
				[1, 0, 0, 0,  1, 0, 0, 0,  1, 0, 0, 0,  0, 0, 0, 0],
				[1, 1, 0, 0,  1, 0, 0, 0,  0, 0, 0, 0,  0, 0, 0, 0],
				[1, 0, 0, 0,  0, 1, 0, 0,  1, 1, 0, 0,  0, 0, 0, 0],
				[1, 1, 0, 0,  0, 0, 1, 0,  0, 0, 0, 0,  0, 0, 0, 0],
				[1, 0, 0, 0,  0, 1, 1, 0,  0, 0, 0, 0,  0, 0, 0, 0],
				[1, 0, 0, 0,  1, 0, 0, 0,  1, 0, 0, 0,  0, 0, 0, 0],
				[1, 0, 1, 0,  0, 1, 1, 0,  0, 0, 0, 0,  0, 0, 0, 0]]
	}
]